1111111111111111111111111
1E0000000000000C000000001
10100V0100100000100010101
1010010010101010000010101
1P0000000C00C0V00000000C1
1010010100100000100010101
101001001010101000V010101
100000000C00C0V00000000C1
1111111111111111111111111