1111111111111
10010000000C1
1000011110V01
100011E000P01
1111111111111