1111111111111
10010000001C1
1000011111101
100011E000P01
1111111111111