1111111111111
11100000000C1
10000V0000001
10000000V0001
1000000000001
1000011111001
1P0111E000001
1111111111111