1111111111111
1001000000CC1
1000011110V01
100011E00PV01
1111111111111